....................
.##################.
.##################.
.##################.
.##################.
.##################.
.##################.
.##################.
.##################.
.##################.
.##################.
.##################.
.##################.
.##################.
.##################.
.###########%######.
.##################.
.##################.
.#&####%##########$.
.@@@@@@@@@@@@@@@@@@.