....................
.##################.
.##################.
.##################.
.##################.
.##################.
.##################.
.##################.
.##################.
.##################.
.##################.
.##################.
.##############%###.
.##################.
.##################.
.########%#########.
.########@@#######$.
.#####@@@@@######@@.
.#&#@@@@@@@%####@@@.
.@@@@@@@@@@@@@@@@@@.
