....................
.##################.
.##################.
.##################.
.##################.
.##################.
.##################.
.##################.
.##################.
.##################.
.#########%########.
.######@@@@@@@@####.
.##################.
.##################.
.#########%########.
.######@##@##@####%.
.##################.
.####@#############.
.#&#@@**********##$.
.@@@@@@@@@@@@@@@@@@.