....................
.##################.
.###########%######.
.###########@###@#$.
.##########@####@@@.
.###############....
.######@###########.
.##################.
.@#################.
.##################.
.#############*%###.
.####*########@@###.
.###@@@###@########.
.##################.
.##################.
.####@#############.
.##################.
.##################.
.#&##**************.
.@@@@@@@@@@@@@@@@@@.