....................
.##################.
.##################.
.##################.
.##################.
.##################.
.##################.
.##################.
.##################.
.##################.
.##################.
.##################.
.##################.
.##################.
.##################.
.##################.
.##################.
.#########%########.
.#&######@@@######$.
.@@@@@@@@@@@@@@@@@@.
