....................
.##################.
.##################.
.##################.
.##################.
.##################.
.##################.
.##################.
.##################.
.##################.
.##################.
.##################.
.##################.
.##################.
.##################.
.##################.
.##################.
.##################.
.#&######@@@######$.
.@@@@@@@@@@@@@@@@@@.
