....................
.##################.
.##################.
.##################.
.##################.
.##################.
.##################.
.##################.
.##################.
.##################.
.##################.
.##################.
.##################.
.####%#############.
.###@@@############.
.##################.
.##################.
.##################.
.#&###############$.
.@@@@@@@@@@@@@@@@@@.
