....................
.##################.
.##################.
.##################.
.##################.
.##################.
.##################.
.#$################.
.@@@###############.
....##@############.
.########@#########.
.#############@###%.
.#################@.
.##################.
.##############@###.
.##################.
.######%####@@#####.
.#####@@@##########.
.#&###############%.
.@@@@@@@@@@@@@@@@@@.
