....................
.##################.
.##################.
.##################.
.#$################.
.@@@###############.
....###%###########.
.######@##########%.
.#################@.
.########@@######@#.
.%#################.
.############@#####.
.##################.
.#####@##########@@.
.##################.
.###########@@#####.
.##################.
.################@@.
.#&################.
.@@@@@@@@@@@@@@@@@@.
