....................
.##################.
.##################.
.##################.
.##################.
.##################.
.##################.
.##################.
.##################.
.##################.
.##################.
.#%################.
.#@@###############.
.##################.
.##########@@######.
.##################.
.######%###########.
.#####@@@##########.
.#&###############$.
.@@@@@@@@@@@@@@@@@@.
