....................
.##################.
.##################.
.##################.
.##################.
.##################.
.##################.
.##################.
.##################.
.##################.
.##################.
.######@@@@@@@@@###.
.##################.
.##################.
.#########%########.
.######@##@##@#####.
.################%#.
.####@#############.
.#&#@@**********##$.
.@@@@@@@@@@@@@@@@@@.