....................
.##################.
.##################.
.##################.
.##################.
.##################.
.##################.
.##################.
.##################.
.##################.
.##################.
.######@@@@@@@@@###.
.##################.
.##################.
.#########%########.
.######@##@##@####%.
.##################.
.####@#############.
.#&#@@***********#$.
.@@@@@@@@@@@@@@@@@@.