....................
.##################.
.##################.
.#################$.
.#######@##@##@#@@@.
.###############....
.#####@############.
.###%##############.
.###@##############.
.##################.
.@######%*#########.
.#######@@@###@####.
.##@@#############%.
.#################@.
.##################.
.###############@##.
.######@###@@######.
.##################.
.#&#@**********####.
.@@@@@@@@@@@@@@@@@@.