....................
.##################.
.%#################.
.@#############@##$.
.##############@@@@.
.###@###@@@@###....
.##################.
.##################.
.##################.
.@#################.
.#######@*#%*######.
.########@@@@@#####.
.##################.
.#################@.
.##################.
.####@######@######.
.####@#############.
.####@#############.
.#&##@*************.
.@@@@@@@@@@@@@@@@@@.